#.##################
#.....##############
#####.###########...
#####.##############
####################
#####.##############
next level
#################.##
#.##################
#....######.......##
####....###.##.##.##
#...###.....#..##.##
####################
next level
####################
####################
###############...##
###############.####
###############...##
####################
